8 8 8 8 8 8 8 8 8 8 8 8 8 8 8 8
8 0 0 0 0 0 0 0 1 0 0 0 0 2 0 8
8 0 0 0 0 0 2 0 0 0 0 0 0 0 0 8
8 0 2 0 0 0 0 0 0 0 0 0 3 0 0 8
8 0 0 0 0 3 0 0 1 0 0 0 0 0 0 8
8 0 1 0 0 0 0 2 0 0 0 0 2 0 0 0
8 0 0 2 0 0 0 0 0 0 2 0 0 0 0 0
8 0 0 0 0 0 0 1 0 0 0 0 0 0 0 8
8 0 0 0 0 2 0 0 0 0 0 0 2 0 0 8
8 0 2 0 0 0 0 0 4 5 6 0 0 0 0 8
8 0 0 0 0 0 0 0 5 6 4 0 0 0 0 8
8 8 8 8 8 8 8 8 8 8 8 8 8 8 8 8